7 6 7 8 6 4 9 3 6 2 10 8 2 6 5 7 4 5 8 
1 10 9 5 3 2 9 2 8 2 2 3 7 5 1 4 2 10 7 
4 7 10 3 6 5 6 9 7 8 5 5 5 4 6 8 9 9 2 
2 6 10 4 6 10 10 3 1 1 5 8 10 6 5 6 6 4 2 
5 10 8 8 6 1 2 8 7 8 5 6 3 7 7 7 7 2 5 
3 4 1 8 5 9 4 5 5 8 6 9 8 3 10 2 2 2 9 
3 9 7 10 7 8 4 1 8 7 2 9 4 7 7 4 4 8 5 
6 2 6 2 9 5 3 5 6 5 8 3 2 10 9 8 7 5 10 
3 1 2 10 3 5 8 8 4 3 4 4 10 9 2 6 3 10 3 
9 7 5 9 3 7 5 4 7 5 10 8 6 8 6 7 2 2 5 
10 1 3 6 1 2 5 1 4 8 9 3 2 8 2 4 1 9 2 
9 8 1 2 8 1 2 7 2 4 9 9 8 4 10 7 4 3 4 
2 3 2 4 3 8 8 4 6 6 4 8 4 7 3 3 3 10 10 
10 10 7 8 1 5 5 9 3 6 4 5 4 6 2 4 1 3 10 
6 8 7 9 1 6 6 8 3 1 3 3 2 6 1 4 9 4 1 
1 6 10 2 7 7 6 1 9 3 2 3 2 9 4 10 2 2 3 
5 5 9 1 10 5 2 8 6 1 3 3 1 9 9 3 6 6 10 
8 7 5 8 7 4 6 5 1 3 2 1 1 1 4 1 7 6 1 
2 4 1 9 7 6 3 4 3 3 4 10 1 6 1 9 10 3 10 
