5 8 8 4 5 4 8 3 7 1 6 9 9 4 8 4 2 5 6 
7 9 9 7 3 4 10 4 5 9 2 6 6 4 6 9 7 5 5 
6 5 5 6 3 2 10 2 1 7 8 9 3 9 10 4 8 2 3 
7 10 3 3 7 3 9 9 6 6 6 2 7 4 10 2 6 4 2 
6 7 4 1 3 5 2 4 3 4 3 5 9 9 10 10 1 3 6 
10 10 4 7 4 4 5 1 9 1 5 1 2 5 4 4 6 10 6 
10 6 8 9 1 3 9 8 3 6 7 6 10 4 7 1 10 7 5 
8 6 9 4 1 3 10 5 4 4 4 9 4 9 9 7 1 3 9 
4 3 10 7 5 1 6 7 10 6 10 1 5 2 5 4 4 7 8 
4 1 5 10 4 7 3 6 7 6 7 8 2 8 10 6 7 3 9 
5 9 3 5 4 2 9 3 3 6 9 4 1 1 5 1 3 1 10 
10 5 8 8 6 2 6 4 7 7 8 5 7 6 1 1 2 4 7 
3 9 6 10 8 6 9 6 10 6 6 2 7 2 4 2 9 3 3 
10 8 9 8 9 6 1 1 10 8 3 6 10 4 9 7 1 7 5 
3 3 6 5 8 5 6 5 8 4 6 3 9 10 8 9 3 1 10 
9 5 4 5 7 1 3 3 10 8 8 8 6 2 9 8 7 2 2 
10 5 10 5 3 1 10 7 3 7 6 5 1 3 6 6 1 10 5 
5 6 2 2 2 4 7 4 7 8 4 5 1 9 10 2 10 7 6 
3 8 3 1 8 7 5 6 1 5 2 8 3 7 1 1 2 7 7 
