8 2 9 7 10 8 5 4 10 7 8 8 5 7 7 8 10 2 5 
4 3 3 7 6 1 2 9 6 4 9 6 2 8 10 4 4 9 8 
7 1 4 6 1 8 10 9 9 10 4 9 5 10 9 8 6 10 7 
2 7 1 5 5 10 7 6 5 5 10 8 7 4 4 9 2 2 3 
9 4 1 6 8 4 6 9 6 1 2 5 7 9 1 8 5 9 1 
9 10 6 4 9 7 1 9 2 4 4 2 4 10 6 2 7 8 6 
7 10 6 3 8 2 2 10 4 9 8 4 10 5 4 2 3 7 8 
2 10 2 7 4 9 5 3 1 1 5 2 8 3 3 1 6 6 1 
10 1 10 8 4 8 3 8 2 2 5 8 7 7 8 6 6 4 10 
3 3 6 1 4 6 10 3 8 7 4 7 10 4 8 8 4 7 1 
3 8 2 2 6 8 6 9 6 9 1 6 9 5 9 10 7 3 3 
10 6 2 7 7 9 5 2 1 9 10 4 5 2 7 3 10 1 9 
6 4 5 8 10 1 5 7 3 1 5 3 1 2 1 2 3 8 1 
1 4 5 4 6 9 5 10 10 1 7 1 4 7 8 10 2 7 7 
8 1 10 7 8 4 1 7 7 2 6 3 3 9 10 9 10 9 9 
8 9 10 9 5 9 8 7 9 7 5 6 10 7 6 8 4 7 5 
4 9 8 1 7 4 10 5 4 3 9 2 9 2 3 3 2 8 8 
2 2 8 5 3 5 9 5 4 7 3 1 3 10 6 3 10 8 4 
9 9 9 3 2 1 4 9 9 6 8 5 6 4 8 5 2 3 6 
