8 11 10 8 11 11 9 12 10 12 11 5 11 11 7 3 12 5 3 
8 6 11 8 11 10 11 12 11 10 11 9 10 7 3 4 12 4 9 
9 12 11 10 3 10 8 7 12 6 6 12 6 12 5 4 6 10 12 
6 3 4 5 8 8 6 3 5 4 8 5 3 7 11 5 5 9 7 
3 5 12 8 10 5 11 8 6 6 12 9 11 10 12 12 3 7 6 
10 6 3 7 12 9 9 5 4 5 8 5 3 3 7 6 10 12 6 
8 3 7 8 3 3 12 4 3 7 7 9 11 10 12 6 3 7 6 
6 6 8 10 3 3 6 7 11 3 8 7 7 9 12 3 3 11 11 
10 6 6 7 8 4 8 5 9 10 9 3 3 8 10 3 12 8 10 
4 6 3 9 10 4 10 5 9 6 3 6 6 12 11 4 5 3 5 
11 11 8 7 7 5 9 12 11 12 9 7 4 12 4 5 12 5 3 
7 6 7 7 11 9 10 12 5 6 5 6 12 4 6 12 7 11 11 
6 7 12 12 9 8 5 7 9 12 4 7 3 10 6 6 3 4 8 
12 12 11 7 8 5 9 8 4 7 6 4 8 7 10 12 4 8 5 
12 11 12 10 4 11 11 3 4 11 10 9 11 6 3 5 5 4 10 
3 3 12 12 9 4 9 3 12 9 5 4 6 5 6 6 11 7 12 
5 3 5 12 3 3 5 5 10 4 6 7 7 8 7 12 10 12 3 
8 8 5 3 12 12 8 4 7 5 9 8 11 9 5 11 6 3 10 
7 3 10 10 9 3 8 4 11 5 5 12 8 6 11 4 12 10 3 
