1 9 2 7 9 6 6 4 4 10 2 9 10 5 2 1 7 7 6 
3 1 7 5 3 1 7 10 4 10 2 5 10 6 6 4 7 8 10 
10 2 10 2 10 10 6 7 2 4 6 5 4 8 3 8 2 9 6 
7 7 4 10 10 5 2 5 5 6 9 1 4 7 1 9 8 3 10 
4 1 4 5 2 7 1 5 8 5 10 3 8 1 6 10 2 5 2 
4 10 6 3 9 7 1 7 2 3 8 6 10 7 10 7 1 1 8 
2 10 4 7 4 7 7 1 8 10 6 5 6 8 4 8 7 7 2 
9 6 5 9 3 7 8 9 10 5 8 9 5 7 9 5 4 5 4 
9 10 7 3 7 9 5 9 8 2 2 3 4 5 8 5 2 4 1 
5 10 1 2 10 2 3 1 4 2 3 6 4 6 10 10 5 4 1 
9 10 1 9 5 1 2 1 3 5 10 9 8 3 10 3 10 3 5 
6 7 1 3 3 3 9 1 4 2 2 3 8 6 1 1 10 5 3 
4 10 5 3 9 7 1 6 5 9 8 5 6 7 3 7 6 7 10 
9 1 2 9 10 2 6 4 8 5 6 7 5 9 10 6 5 5 2 
7 4 3 7 3 6 1 8 4 10 10 4 6 6 7 1 4 9 7 
8 1 4 7 4 1 6 7 4 6 10 3 5 2 9 4 5 7 4 
7 1 10 9 5 8 10 8 6 2 4 9 10 7 5 8 3 8 9 
10 6 9 5 1 7 10 1 1 5 3 6 5 10 3 10 1 1 10 
3 4 1 1 7 2 4 5 10 4 6 7 1 9 7 4 5 8 5 
