1 10 2 1 1 9 6 7 7 2 7 9 10 3 2 3 2 3 7 
9 1 4 9 5 8 7 7 10 4 2 8 3 9 1 8 9 8 10 
8 9 7 9 1 3 4 10 9 2 8 8 2 7 2 6 1 6 3 
7 2 5 4 4 10 4 7 3 4 6 7 6 3 9 5 2 4 5 
1 7 3 4 10 9 6 4 4 1 9 1 2 4 5 10 8 10 3 
5 7 1 3 5 4 1 9 6 9 7 8 3 2 8 6 5 1 6 
2 4 10 7 5 4 10 1 5 10 8 1 1 5 8 3 3 5 7 
9 10 9 10 10 3 5 3 10 3 8 4 8 6 10 1 9 3 5 
3 2 6 4 10 3 8 3 7 10 4 1 10 9 8 7 3 6 6 
10 4 9 7 2 1 4 4 8 8 4 4 10 3 8 10 5 6 5 
1 2 10 2 2 6 6 2 1 5 2 2 10 8 5 9 5 2 3 
10 3 1 5 6 6 8 2 5 10 10 10 4 2 6 6 5 4 3 
6 10 6 2 8 2 5 10 6 8 1 9 10 5 7 8 8 6 1 
4 7 8 10 8 2 9 7 10 8 2 6 8 7 4 3 2 10 5 
1 7 9 4 8 7 9 1 4 4 9 8 9 1 10 5 2 4 8 
1 4 5 3 9 10 6 5 6 2 6 8 3 7 8 8 7 8 1 
1 8 3 6 6 6 2 4 1 2 7 10 6 6 6 10 5 8 9 
2 5 6 3 2 4 2 9 2 9 5 1 7 10 10 6 1 8 8 
1 7 9 3 5 5 9 5 10 2 8 1 3 5 9 4 5 10 5 
