10 8 4 6 3 4 6 4 1 8 9 5 4 8 10 2 8 5 5 
8 7 6 4 8 1 6 5 2 5 2 8 8 10 10 3 7 9 4 
6 8 6 4 2 5 10 1 3 8 7 3 7 10 1 5 9 2 6 
6 1 1 5 9 6 5 3 10 4 9 4 3 5 6 1 1 4 8 
5 10 2 7 5 1 5 9 5 5 7 6 3 10 9 2 3 5 8 
1 10 2 3 7 8 6 3 7 3 10 1 10 6 6 9 5 10 9 
6 1 4 6 7 5 9 6 8 5 3 3 2 9 8 1 7 8 3 
8 9 7 3 10 5 9 9 9 8 10 9 10 8 6 9 7 8 9 
2 1 1 4 6 9 4 3 7 8 1 8 5 1 10 4 2 8 4 
6 5 7 5 3 9 4 1 5 1 5 4 8 9 4 6 10 1 3 
7 7 2 5 10 5 7 6 6 3 4 6 4 1 8 7 4 9 9 
1 7 1 2 5 3 9 1 9 1 2 4 3 7 5 8 5 1 3 
10 10 7 4 2 6 7 10 2 2 10 10 2 1 2 10 8 7 1 
1 5 1 9 2 5 6 7 8 2 9 4 1 7 9 5 5 8 9 
1 10 4 4 7 4 4 1 1 8 3 1 4 10 4 9 7 4 3 
4 10 5 8 3 2 5 8 8 4 1 1 4 2 8 9 4 2 2 
6 5 6 5 7 6 1 6 7 5 1 5 6 5 2 8 8 4 2 
3 2 6 9 5 5 3 1 4 2 5 4 2 2 6 10 3 3 7 
5 9 9 2 6 9 5 8 9 3 4 9 4 6 8 5 8 3 5 
