5 4 5 3 6 8 6 1 6 1 4 5 2 7 3 5 2 4 4 
7 10 6 6 3 10 10 5 7 1 4 2 5 10 7 4 3 5 8 
2 1 7 9 4 10 6 4 4 6 3 9 3 1 1 5 3 8 6 
10 5 3 4 3 6 9 1 8 4 6 3 4 1 8 9 7 10 10 
6 6 2 4 1 7 1 3 1 1 10 2 1 2 8 1 7 1 9 
2 10 6 8 8 4 10 5 2 10 10 10 1 5 5 3 8 7 10 
9 6 6 3 6 7 2 10 4 6 7 8 5 5 5 4 6 4 6 
1 5 2 7 8 7 10 9 8 6 9 1 6 2 2 6 6 8 1 
7 8 10 4 2 6 5 9 3 7 9 3 4 6 5 4 10 6 6 
6 6 7 1 1 6 6 7 3 8 1 3 10 5 3 4 4 4 8 
4 5 2 5 2 9 3 6 5 9 6 3 8 1 8 10 1 3 9 
2 10 6 10 8 5 2 10 1 9 5 10 3 2 7 4 4 6 1 
5 8 5 10 2 10 8 2 3 3 6 3 2 4 6 9 8 3 9 
4 2 5 10 5 9 7 8 10 9 5 6 3 7 1 1 5 8 5 
8 6 10 9 5 10 9 1 10 4 4 10 6 1 7 5 2 7 3 
4 10 4 1 4 10 10 3 8 4 9 2 4 7 5 6 5 9 1 
4 9 1 3 2 4 1 7 9 5 6 6 7 3 3 4 8 5 9 
9 5 6 9 9 1 9 6 1 3 9 6 4 3 5 4 5 8 10 
3 1 10 4 3 8 9 6 5 3 4 9 1 4 7 8 6 5 10 
