10 6 8 3 10 8 10 10 4 4 2 9 9 6 2 1 2 8 2 
10 8 4 7 10 1 10 1 6 10 3 6 2 2 6 7 9 4 3 
9 7 4 3 10 7 10 3 10 7 8 10 5 10 9 1 7 4 7 
9 1 9 9 2 6 2 6 9 9 1 9 5 4 7 10 9 4 5 
4 10 10 9 3 9 7 1 2 7 4 2 8 8 6 2 4 6 4 
9 6 7 7 2 7 4 2 3 8 7 5 9 7 6 1 8 9 5 
9 7 6 6 7 10 6 8 5 2 8 1 3 9 3 7 7 8 2 
10 7 7 2 1 2 1 9 9 8 1 1 10 3 7 3 4 1 2 
1 8 5 7 9 1 5 7 8 2 8 1 6 1 8 6 3 3 6 
5 10 7 9 1 1 6 1 8 5 10 10 3 2 8 3 3 6 7 
1 4 9 10 1 8 1 10 2 1 5 4 5 9 5 1 10 6 2 
8 5 4 10 7 3 10 3 10 5 3 9 5 1 9 1 3 9 10 
1 4 9 4 4 9 7 9 2 7 4 2 7 7 8 10 4 7 3 
5 2 3 6 7 9 9 6 10 2 2 9 1 6 5 8 7 6 2 
8 1 1 7 8 1 10 1 2 5 2 6 9 7 7 1 7 5 2 
5 2 4 10 9 10 9 1 5 7 3 9 5 4 8 6 8 2 7 
5 8 6 9 5 10 8 7 6 4 5 3 1 4 8 9 9 2 1 
3 3 5 7 9 7 4 2 1 7 6 6 8 10 8 2 7 7 7 
1 1 1 3 7 6 5 6 9 1 9 10 7 7 2 7 4 8 8 
