2 1 9 4 1 7 8 10 1 9 8 10 4 6 3 7 9 10 6 
10 1 10 7 10 5 3 2 6 1 4 4 5 5 6 6 3 6 4 
6 10 10 3 4 6 1 10 5 10 10 8 9 8 2 6 8 10 5 
3 6 7 10 6 6 3 2 7 9 3 7 9 7 3 8 3 1 10 
3 4 4 7 3 5 1 1 9 8 10 10 4 6 5 6 3 3 7 
7 4 9 5 1 9 9 3 4 8 4 1 10 8 3 5 7 7 8 
10 9 5 7 1 7 8 5 3 3 3 10 5 8 8 8 8 9 9 
4 9 5 5 2 2 6 9 6 8 1 6 6 5 7 8 6 1 6 
2 9 2 8 2 5 4 9 1 3 3 3 2 6 3 10 2 8 8 
8 9 4 7 10 5 1 8 10 9 9 4 6 4 4 9 1 9 3 
8 6 4 6 2 5 1 7 3 10 9 5 9 9 5 5 2 4 8 
6 3 2 4 4 6 8 3 4 7 5 2 4 1 3 6 6 5 5 
9 7 9 4 5 1 1 8 8 1 9 7 10 1 6 9 3 10 1 
3 4 4 8 9 2 10 9 10 6 6 8 10 10 8 5 10 3 3 
1 9 3 9 2 8 8 7 1 7 1 2 7 5 9 2 7 5 7 
9 8 6 8 10 9 3 1 5 4 1 8 4 5 2 9 10 1 3 
7 1 8 8 3 7 4 4 5 6 8 7 2 4 6 4 5 1 4 
6 6 3 7 2 3 4 3 1 2 7 5 2 6 7 5 3 7 1 
2 6 6 2 3 6 2 3 4 1 6 3 4 7 1 9 6 6 9 
