8 8 2 10 8 3 2 9 6 7 9 9 2 7 3 8 10 10 5 
2 7 3 6 4 8 10 2 3 2 9 7 7 8 9 3 8 3 8 
7 2 2 6 2 9 9 4 8 3 9 2 5 4 8 6 2 5 6 
10 5 6 10 9 7 10 2 5 3 6 10 4 5 8 7 2 3 7 
3 7 6 10 1 9 3 7 1 8 4 7 6 8 3 8 1 9 5 
1 1 9 4 8 4 4 4 5 10 5 3 7 2 6 8 5 8 8 
2 10 4 6 9 9 2 5 2 8 5 7 8 10 8 2 3 5 3 
6 3 2 9 4 1 1 7 10 5 2 2 1 1 2 9 3 8 1 
4 5 8 1 9 8 3 4 1 8 6 8 4 3 3 10 1 3 4 
7 5 3 7 8 9 2 5 1 8 7 6 8 2 4 8 7 10 9 
3 6 10 3 2 10 7 9 9 10 1 2 1 5 6 5 1 6 9 
5 9 5 3 10 3 9 10 6 6 2 2 6 9 6 8 2 4 9 
4 10 8 2 7 4 9 8 5 7 6 9 4 3 7 5 8 9 2 
10 6 4 5 3 8 7 7 5 2 7 3 3 2 3 5 4 6 9 
3 1 8 2 5 10 1 3 2 4 1 8 2 5 2 3 10 10 10 
6 3 8 4 2 10 7 7 4 7 5 4 2 9 1 5 2 7 3 
8 2 3 7 8 7 2 9 9 9 10 1 6 4 2 1 1 6 5 
6 2 7 3 8 10 7 8 2 10 9 7 8 8 1 7 8 1 8 
9 4 9 8 6 6 2 6 8 7 9 7 1 6 1 9 10 5 8 
