9 7 7 5 10 2 7 1 1 6 9 8 2 6 10 3 9 9 5 
10 4 3 6 1 4 4 2 8 4 5 5 6 10 8 8 8 9 10 
9 8 9 4 9 4 2 5 1 5 4 8 7 8 5 7 10 3 1 
7 1 4 3 9 1 10 10 2 6 8 6 7 3 5 5 10 7 10 
8 2 2 7 9 9 7 3 4 2 7 3 1 5 7 3 4 5 6 
7 3 5 5 10 7 2 1 6 2 4 6 3 1 9 10 2 2 2 
4 9 10 7 9 9 6 4 3 5 6 3 9 7 1 9 8 1 8 
1 4 2 5 6 7 3 9 9 2 3 4 9 1 9 5 6 2 8 
6 10 5 5 3 7 3 10 9 4 5 8 7 2 8 6 8 6 5 
1 3 6 4 8 3 3 8 8 6 5 3 5 4 2 6 10 8 6 
5 2 5 7 1 7 2 7 7 10 2 3 7 1 4 8 7 7 3 
8 10 2 9 1 8 1 10 10 8 7 8 7 10 5 4 3 3 4 
8 5 2 10 7 10 9 3 8 10 7 3 6 7 6 6 5 1 4 
6 8 10 5 9 1 10 6 3 9 2 10 3 3 3 2 5 3 7 
2 7 8 8 6 9 10 4 1 9 6 4 10 8 4 1 6 8 10 
1 8 6 8 4 1 8 5 1 3 8 2 8 10 6 4 4 4 10 
1 1 9 3 2 4 5 2 6 4 2 6 3 4 6 10 7 3 6 
5 6 1 8 10 10 10 8 8 2 1 1 1 7 5 8 3 9 1 
10 3 8 7 5 8 9 2 2 9 7 8 8 4 8 7 9 4 1 
