9 5 1 10 6 7 6 2 8 1 4 5 6 3 8 2 8 9 10 
3 7 6 3 3 5 8 2 2 9 7 6 8 3 3 4 2 7 3 
6 5 2 3 4 9 2 10 4 1 9 3 6 4 6 10 2 10 7 
6 10 2 1 10 1 4 7 2 7 8 6 2 2 1 10 4 7 4 
3 10 10 10 8 6 10 9 8 10 9 4 5 4 8 6 9 3 7 
2 6 9 8 5 5 7 2 8 7 8 7 10 5 4 10 6 4 2 
2 5 6 8 6 8 8 9 1 4 2 4 4 9 5 4 1 3 9 
3 5 6 10 7 3 8 9 6 9 6 4 9 10 1 4 3 6 9 
9 5 5 9 5 3 6 8 3 9 10 6 10 6 5 9 9 8 4 
1 1 3 10 7 5 2 8 5 4 10 4 7 1 2 8 8 8 7 
3 10 9 4 9 7 4 9 8 10 9 8 10 10 7 8 1 3 6 
2 1 7 3 5 4 2 9 5 8 3 3 9 9 6 9 10 6 1 
7 3 2 5 5 1 7 9 8 9 2 8 6 7 3 3 3 1 6 
6 7 9 5 8 7 2 6 9 4 5 2 10 3 6 1 6 2 10 
5 2 5 7 2 3 6 10 9 4 3 7 9 4 10 10 5 1 10 
3 4 9 7 7 3 2 1 9 1 10 3 2 10 8 3 5 2 9 
3 2 4 7 4 1 4 2 6 2 8 1 1 4 3 2 5 1 4 
6 9 1 1 10 9 7 3 5 1 1 8 7 4 10 10 7 1 10 
1 10 1 8 3 7 3 5 4 7 1 8 6 4 4 8 3 4 3 
