8 6 11 4 5 6 3 4 4 8 7 4 4 5 10 4 7 10 6
4 11 6 3 9 6 4 4 4 12 6 3 7 12 5 3 9 11 5
11 3 3 9 10 7 4 5 9 5 10 8 9 10 4 11 11 5 7
11 3 8 3 11 10 7 6 4 7 11 3 10 10 4 12 10 5 7
7 4 9 10 9 8 4 7 11 11 4 10 10 12 11 9 5 10 9
4 6 8 9 4 11 9 7 6 9 7 7 6 12 6 4 12 6 6
8 8 4 10 11 6 7 5 7 5 9 6 7 5 6 9 6 5 6
11 4 7 8 8 8 5 3 12 9 7 3 3 4 11 4 5 7 8
11 6 10 3 11 3 9 12 4 9 10 5 8 10 6 3 12 4 3
8 11 8 6 11 8 10 5 3 6 7 9 5 8 12 5 4 10 8
8 6 10 11 6 5 3 7 11 7 3 9 12 4 7 4 8 11 7
5 7 3 8 11 8 3 8 8 3 11 8 11 3 3 4 9 7 11
5 12 6 8 9 5 7 12 9 9 4 8 8 6 7 9 6 12 11
7 7 6 6 12 7 10 12 4 8 7 12 11 12 3 9 10 4 11
7 4 7 10 6 3 4 3 11 12 10 7 8 12 11 8 7 5 4
12 10 6 5 8 12 8 12 7 10 8 12 6 11 9 10 9 3 10
5 3 4 3 4 7 10 8 4 8 12 3 3 5 6 8 11 6 7
7 7 8 3 5 9 8 6 12 9 6 11 7 4 7 10 10 5 3
7 12 8 7 12 11 11 3 3 12 4 7 6 3 6 12 11 5 11
