5 2 8 7 4 6 9 8 8 7 10 3 8 8 10 1 6 3 8 
5 5 4 7 6 3 6 9 1 7 7 3 7 5 7 8 9 9 5 
7 5 9 1 8 2 5 9 7 5 9 9 10 7 7 6 2 3 7 
2 9 10 10 9 9 2 1 2 3 2 4 1 4 7 4 1 1 9 
8 3 7 7 7 6 8 9 7 3 1 4 9 3 3 1 5 10 6 
8 9 5 10 3 3 6 5 9 9 5 8 10 2 2 1 9 2 8 
10 10 9 1 2 6 10 3 9 8 7 4 6 5 2 7 6 5 5 
5 2 9 4 8 10 1 5 6 1 6 2 2 5 7 10 3 10 10 
8 5 10 1 8 8 8 1 3 2 6 2 4 8 8 3 7 6 3 
4 5 10 5 3 1 4 9 8 6 10 4 7 5 1 7 2 10 8 
3 10 3 6 9 2 7 2 3 9 6 7 7 7 6 6 4 1 5 
2 2 6 6 10 10 10 6 9 7 5 9 6 8 6 7 10 4 6 
2 3 6 4 4 6 5 6 8 5 6 1 8 3 1 1 9 3 8 
9 5 10 1 6 7 7 4 9 5 2 6 5 4 9 8 2 4 2 
5 3 5 5 10 9 8 4 7 6 7 8 7 2 7 1 6 6 6 
1 6 2 2 8 9 5 7 1 6 9 6 3 10 4 1 4 1 1 
4 1 7 4 6 7 5 10 6 8 5 10 10 6 3 6 10 7 4 
9 9 1 7 9 9 5 5 2 7 1 4 10 8 6 6 5 6 6 
9 6 5 5 10 1 4 3 5 2 8 3 9 2 4 4 6 5 1 
