2 2 7 9 5 2 9 2 3 7 5 3 9 1 4 9 2 5 1 
5 3 7 6 7 5 4 10 7 8 5 3 5 1 4 1 5 5 6 
6 2 3 2 1 9 5 1 1 4 10 9 7 4 3 6 7 6 4 
6 1 5 2 7 1 8 5 9 5 9 9 9 8 8 4 3 7 6 
6 5 1 2 6 3 5 4 7 8 7 1 10 7 10 7 4 9 2 
2 2 9 3 7 7 1 9 7 1 1 3 6 6 4 2 9 6 1 
6 2 6 3 5 8 7 6 1 6 8 4 1 8 4 7 10 8 3 
10 9 2 10 9 9 3 7 10 5 8 10 7 5 4 2 1 6 9 
2 1 4 5 2 7 7 4 7 9 9 7 6 9 1 7 7 5 4 
3 3 1 9 1 7 9 2 5 2 5 5 8 8 3 4 2 6 7 
5 10 10 2 6 10 4 7 4 2 8 3 5 3 3 7 6 2 7 
5 1 1 8 6 4 10 9 2 2 6 1 7 8 8 8 10 4 6 
5 1 10 2 10 10 2 3 5 3 2 7 6 10 3 1 8 5 3 
9 1 4 7 5 8 4 4 2 2 6 3 9 7 1 4 7 1 4 
8 5 7 1 8 2 9 3 9 3 9 9 10 6 2 3 10 1 7 
1 3 9 6 1 2 7 9 8 9 8 5 8 8 7 8 1 1 8 
2 9 9 9 7 8 7 6 10 8 3 8 2 4 8 5 4 6 6 
4 1 1 1 8 3 1 10 5 7 5 7 5 6 8 2 2 6 6 
10 2 9 1 10 8 2 8 10 9 1 4 7 10 9 3 1 8 1 
