3 9 6 9 1 6 2 2 8 8 7 5 9 5 2 1 1 10 2 
2 6 4 9 8 7 8 7 2 8 3 7 5 3 10 10 1 7 8 
1 8 9 8 7 6 5 2 2 1 9 8 1 3 8 3 2 1 10 
1 3 9 2 9 10 7 2 10 9 9 7 3 3 6 4 5 10 2 
6 8 9 8 7 2 8 1 9 1 2 1 9 1 8 5 6 1 10 
6 2 8 8 4 10 1 6 7 10 4 8 2 7 7 1 1 2 6 
6 1 9 10 3 9 6 7 7 6 4 8 9 4 4 6 1 6 3 
5 8 1 5 1 9 9 10 10 3 7 3 2 2 6 9 6 7 9 
8 5 3 6 2 4 4 9 8 5 6 10 8 2 1 3 10 6 1 
4 8 4 7 1 1 9 6 2 6 9 10 9 6 7 9 6 3 4 
9 5 5 10 6 6 4 6 5 4 1 2 10 1 2 7 10 2 6 
2 7 3 1 2 2 10 8 6 5 4 1 3 5 4 5 5 6 6 
1 4 8 10 7 4 3 6 1 2 6 1 5 8 7 7 9 1 8 
8 10 2 8 4 7 5 4 2 6 9 4 3 3 5 2 3 4 6 
8 1 6 4 7 10 6 5 8 4 10 10 7 3 9 5 8 1 3 
3 2 4 2 10 9 1 3 9 6 6 9 5 6 2 4 1 9 5 
9 9 9 1 4 3 1 2 10 9 7 4 10 4 8 5 4 9 1 
10 4 4 6 5 5 8 10 8 2 2 6 10 3 4 10 7 4 3 
1 6 9 7 5 3 7 4 1 3 4 5 2 9 10 3 6 4 8 
