4 10 4 10 9 10 9 7 10 9 3 4 10 9 2 3 3 4 3 
8 1 8 7 2 4 2 6 4 10 1 9 2 7 3 7 8 5 2 
7 6 8 5 2 9 9 7 5 1 9 6 4 6 5 5 5 4 8 
9 1 8 1 10 10 3 9 8 10 10 3 7 1 10 5 5 10 8 
10 8 5 4 10 9 2 1 8 2 7 5 7 4 8 6 10 2 7 
5 3 5 8 7 1 10 8 2 8 1 1 10 2 6 10 8 4 6 
9 6 4 8 1 7 5 1 2 3 8 6 3 7 8 5 1 4 2 
7 3 10 2 9 7 4 9 5 9 10 10 2 9 1 1 4 5 4 
3 9 1 8 10 10 6 2 10 6 9 8 8 5 4 1 8 4 9 
5 8 9 8 5 3 3 9 9 9 2 6 5 6 4 3 8 2 6 
4 5 6 10 7 4 8 10 5 7 8 2 4 10 4 6 9 1 1 
5 9 10 4 6 5 1 9 9 10 3 5 6 1 6 7 5 7 7 
7 3 5 1 4 10 6 6 1 6 9 2 1 10 3 1 4 3 2 
2 6 4 7 10 2 6 4 8 7 7 2 3 1 2 8 3 8 1 
7 6 2 5 10 10 10 6 10 1 5 6 5 2 5 6 7 10 7 
9 3 10 1 4 6 9 3 4 8 6 6 5 4 4 3 10 2 7 
6 6 2 10 6 5 5 4 8 7 7 10 8 7 2 3 10 8 1 
10 1 7 4 5 2 8 3 3 7 9 2 6 2 3 5 9 10 9 
4 10 7 5 1 7 8 3 2 2 4 2 2 5 8 4 2 2 4 
