4 7 3 6 4 4 4 2 5 4 1 2 3 3 6 9 2 9 3 
4 1 3 9 7 8 1 5 2 10 7 6 10 7 9 8 4 3 9 
10 2 5 10 2 2 6 10 4 9 7 4 7 9 2 9 2 5 1 
3 6 4 7 1 8 6 5 9 3 1 1 1 8 2 6 6 1 7 
4 5 6 6 3 2 9 1 2 8 5 7 4 4 4 1 4 2 4 
9 9 1 8 8 1 3 2 9 6 6 2 5 1 10 8 9 9 3 
9 7 3 2 7 4 8 10 9 10 3 7 7 2 7 5 8 1 1 
2 7 8 7 10 2 3 4 1 1 6 6 5 9 8 4 9 10 6 
8 3 10 7 1 10 5 8 6 3 5 5 4 10 8 10 5 6 6 
1 7 8 3 7 2 8 8 1 4 8 4 10 2 9 8 5 7 1 
10 9 1 5 6 4 1 8 7 10 4 4 2 7 1 3 10 4 4 
6 5 2 5 5 4 5 8 5 9 10 9 10 1 6 2 4 5 4 
10 6 4 10 8 9 8 5 3 8 5 5 10 3 3 6 2 2 9 
6 3 9 5 5 4 8 8 10 2 7 6 2 2 2 3 10 7 4 
10 9 5 9 6 5 1 5 3 9 5 3 3 10 10 10 5 10 4 
7 5 8 6 10 4 7 8 8 5 1 6 5 8 4 4 5 7 7 
8 9 1 4 5 2 6 10 7 10 5 10 4 2 2 10 2 10 7 
5 3 4 1 1 6 9 6 6 8 8 7 2 4 5 5 5 5 3 
6 9 9 4 7 10 1 9 8 4 10 7 6 8 3 8 10 1 10 
