7 7 3 5 2 5 9 6 2 4 5 1 1 2 3 10 1 4 8 
5 5 1 9 8 3 3 5 8 4 2 6 9 5 3 8 7 2 3 
10 7 2 2 3 1 2 8 6 4 8 2 8 3 9 9 10 10 10 
3 6 8 9 5 2 10 4 6 6 10 4 8 2 7 10 7 4 8 
7 7 10 4 9 9 4 7 8 3 5 10 5 4 3 6 5 4 4 
1 6 9 9 3 4 3 5 9 8 10 5 5 8 10 10 7 4 6 
5 5 10 1 1 5 3 5 1 4 10 7 10 7 5 3 4 6 1 
2 7 10 5 3 7 9 9 9 5 4 9 1 10 5 7 7 3 8 
6 7 7 3 8 6 7 4 4 6 6 1 2 3 7 10 9 8 2 
8 5 10 4 6 5 2 8 10 3 3 7 10 7 5 6 2 6 9 
5 8 9 2 2 1 5 7 2 7 5 8 9 8 8 10 6 9 2 
1 4 5 9 4 6 7 10 8 3 7 10 6 6 8 10 1 1 7 
5 2 6 4 1 4 7 9 10 7 2 9 3 7 7 10 1 1 3 
9 2 3 2 1 5 1 9 7 8 7 8 2 4 3 3 2 2 10 
3 3 4 1 8 1 3 8 9 8 3 9 9 7 7 10 5 7 4 
4 5 9 7 10 2 3 2 10 10 6 4 2 10 7 6 7 7 6 
8 10 3 2 1 10 7 8 6 5 5 3 7 3 10 3 7 2 6 
2 3 3 7 4 6 10 5 10 6 10 10 2 6 10 10 6 5 9 
4 7 1 2 2 8 6 4 4 8 10 5 5 7 1 3 9 8 2 
