3 4 8 7 1 7 10 3 4 7 9 1 10 7 6 8 2 5 6 
5 2 5 5 9 2 7 6 6 1 6 7 2 2 3 8 5 9 2 
6 1 1 5 10 9 5 4 9 4 1 5 5 1 8 5 5 2 7 
9 3 9 3 2 1 1 6 10 6 6 7 2 7 5 2 2 3 8 
5 6 10 9 8 7 6 4 4 6 4 5 5 5 2 3 9 7 3 
4 9 2 2 2 4 2 10 1 10 4 5 6 6 6 1 2 6 6 
2 5 2 2 7 4 6 8 4 9 1 7 10 8 7 6 4 1 9 
10 10 7 10 2 1 9 6 8 7 2 9 4 9 4 10 5 8 9 
7 10 2 3 8 4 8 9 4 8 9 3 8 7 2 7 2 1 5 
3 4 1 8 9 9 8 7 1 3 6 9 2 8 6 4 1 2 5 
6 9 6 4 2 2 9 7 5 8 2 2 7 6 2 8 4 9 5 
3 2 10 4 2 10 2 6 2 1 1 4 7 5 6 9 9 4 4 
5 3 9 10 3 2 8 2 4 4 1 2 4 6 6 9 1 7 10 
3 5 1 4 9 8 5 5 2 3 5 4 1 8 3 8 2 10 3 
1 5 4 2 6 6 6 2 1 1 4 3 3 2 7 1 9 2 8 
9 5 3 6 5 10 5 8 2 1 5 8 4 5 7 10 8 1 6 
7 2 6 8 2 5 3 6 7 1 5 7 1 10 4 5 6 10 8 
3 2 5 7 5 1 1 8 9 5 6 4 3 9 1 6 5 9 3 
1 7 3 6 3 2 5 3 4 3 3 1 9 3 2 4 8 6 3 
