3 10 6 5 3 10 9 9 3 10 6 8 10 4 7 3 3 4 5 
1 6 3 1 9 7 5 2 10 1 5 8 2 1 1 6 10 3 2 
8 8 9 2 9 2 5 8 3 1 9 8 1 6 10 5 8 10 3 
1 1 9 7 2 3 5 7 1 4 2 6 3 7 10 10 10 9 7 
2 1 10 1 6 10 8 8 2 3 7 4 4 7 2 5 1 1 6 
5 7 7 2 6 10 7 4 6 9 10 9 8 8 7 4 7 2 7 
3 8 5 9 6 2 2 7 5 8 7 5 10 7 8 5 9 10 5 
5 9 3 7 3 9 10 10 5 9 1 5 3 7 10 5 5 9 1 
7 7 4 3 8 10 4 4 1 5 8 9 6 3 3 10 4 10 1 
4 7 6 2 3 8 7 9 7 8 7 7 9 3 1 3 4 9 1 
4 1 10 9 1 10 2 5 5 10 1 3 6 2 9 8 1 8 5 
1 7 5 5 3 1 7 4 1 10 4 7 6 6 8 2 1 2 2 
2 5 5 4 4 5 8 1 7 4 4 10 7 6 9 8 1 7 5 
5 4 6 5 8 8 5 8 7 6 2 9 6 7 6 7 3 8 6 
8 7 4 4 4 3 5 10 1 5 3 4 5 7 7 6 8 5 6 
6 7 7 4 10 10 10 1 4 1 3 6 9 2 5 6 6 3 3 
10 8 9 10 8 2 6 2 4 4 2 8 6 5 10 10 3 1 3 
3 6 10 6 1 9 6 8 5 1 8 7 9 8 2 7 1 2 2 
8 7 4 8 2 5 9 2 8 1 10 3 6 1 1 9 8 5 9 
