3 3 3 5 7 5 9 2 7 8 5 7 2 2 10 5 1 3 8 
10 10 8 7 6 1 9 5 4 6 6 10 1 1 3 5 7 9 2 
1 5 7 10 10 2 1 5 7 6 7 10 7 1 7 10 4 5 10 
5 5 6 1 10 3 2 4 1 4 7 9 4 10 7 8 5 7 5 
1 8 6 4 6 7 8 10 3 6 10 3 4 10 9 4 7 9 5 
8 7 1 8 8 4 3 4 4 3 5 10 5 6 8 4 2 6 6 
4 6 3 1 3 3 9 6 3 10 3 6 6 5 9 2 4 10 8 
2 9 1 5 10 2 8 7 9 9 4 10 4 2 4 1 1 1 3 
2 3 10 4 1 8 9 3 10 8 10 3 1 8 3 3 6 3 7 
4 1 6 10 2 3 6 10 7 5 9 8 6 10 1 9 5 8 3 
8 8 1 2 3 8 4 9 6 6 3 3 5 2 5 3 7 4 1 
6 3 9 4 4 6 4 6 2 2 9 7 2 5 8 9 3 1 7 
10 10 1 10 6 9 2 9 4 5 10 1 3 7 6 2 2 8 2 
5 3 2 9 2 3 7 10 3 1 9 8 2 4 4 6 4 6 9 
10 8 4 1 3 3 5 6 10 4 2 5 6 2 8 3 9 1 3 
9 1 1 6 7 5 4 5 5 1 2 9 5 9 5 8 9 4 10 
4 3 4 6 9 8 3 7 10 3 3 4 2 7 4 8 5 1 6 
5 7 2 7 4 10 10 6 10 9 8 3 5 2 9 10 7 6 2 
7 1 1 8 1 7 7 1 3 8 7 10 6 9 6 9 6 4 6 
