3 10 4 2 3 6 5 7 4 1 10 3 7 5 4 9 10 2 5 
3 6 7 3 1 1 9 2 7 3 9 6 9 5 1 2 9 1 7 
2 4 7 6 5 10 4 2 4 6 6 1 4 3 1 4 10 2 2 
3 6 5 5 2 6 5 6 9 5 10 1 1 5 1 8 4 5 6 
8 8 4 7 1 6 7 6 2 7 5 9 8 7 5 7 2 6 3 
5 4 2 1 3 7 2 9 1 8 3 9 4 9 7 9 6 2 3 
4 8 5 9 6 7 6 9 7 10 3 3 6 4 1 4 2 5 3 
10 7 5 7 1 5 8 2 9 1 10 9 1 8 2 8 10 9 7 
4 2 4 2 5 5 2 1 7 2 3 6 3 8 10 7 5 5 6 
1 6 9 1 10 4 6 6 3 7 6 5 7 8 4 1 2 8 5 
6 6 4 2 8 9 6 3 1 9 8 7 1 1 5 5 8 8 1 
2 7 8 5 3 4 8 7 2 7 9 2 5 1 5 6 10 8 1 
8 7 9 10 4 5 1 5 9 7 3 1 8 4 8 5 2 2 9 
1 6 4 9 5 9 8 1 5 9 3 3 3 4 4 5 5 1 7 
3 8 8 10 1 6 8 6 1 10 4 6 5 4 1 4 3 9 3 
8 1 7 3 10 7 3 1 1 6 3 4 7 4 2 8 4 10 5 
8 4 9 9 3 4 1 2 9 3 10 8 3 9 8 10 4 9 6 
9 5 10 10 10 5 2 3 9 6 7 7 4 2 1 10 8 1 8 
6 8 10 7 9 6 9 2 7 4 7 8 8 9 8 9 4 10 9 
