5 2 10 8 9 8 3 1 9 7 10 5 3 7 9 8 7 9 10 
3 2 10 5 6 8 4 7 8 5 3 1 2 3 3 5 10 5 3 
7 2 8 5 5 9 5 7 7 5 1 1 5 2 8 1 1 8 7 
7 10 7 5 7 8 10 1 6 9 7 2 6 8 4 5 2 2 7 
6 7 10 7 7 3 4 10 7 4 4 7 5 3 7 4 5 1 7 
10 4 4 7 9 10 2 9 10 3 5 4 9 4 6 8 3 10 1 
7 5 10 10 8 7 9 9 9 4 4 6 4 3 5 7 9 5 3 
4 3 9 8 2 5 8 6 9 2 7 3 4 2 6 6 9 4 4 
3 6 3 7 10 1 4 1 8 6 4 3 10 7 10 7 4 1 5 
1 6 6 1 8 10 3 6 7 8 4 1 6 3 8 7 1 1 5 
10 7 9 2 5 8 10 3 7 8 7 5 2 10 6 6 9 8 5 
8 4 1 5 3 5 3 4 8 5 2 2 1 9 5 10 3 1 5 
5 10 1 5 3 3 10 9 3 6 2 8 5 8 5 8 8 3 1 
9 1 4 10 10 7 10 3 5 6 6 8 4 7 5 4 10 10 4 
3 2 3 7 1 8 2 5 10 10 10 5 1 5 5 9 1 3 2 
1 4 3 5 7 8 7 2 2 8 2 2 3 5 3 3 2 5 10 
4 5 7 2 1 3 6 3 8 5 5 7 10 2 7 9 9 3 8 
1 3 4 2 7 7 4 2 2 1 2 3 7 4 4 10 2 7 4 
3 3 8 1 8 10 7 4 5 3 5 2 3 4 7 4 5 8 1 
