8 9 7 4 9 2 9 5 10 4 1 1 9 9 5 1 2 1 8 
1 9 6 3 2 3 2 3 8 10 2 5 8 3 7 4 3 5 10 
7 7 5 10 2 8 10 10 1 3 5 2 4 9 1 8 6 6 9 
2 9 1 6 5 9 9 8 2 9 3 8 9 2 4 4 2 5 7 
4 4 8 6 10 6 8 10 3 1 4 4 4 9 4 6 5 1 9 
1 6 6 6 9 8 4 7 6 9 8 8 2 6 1 4 7 9 3 
2 7 5 5 3 1 9 9 3 2 6 5 9 7 2 7 1 10 5 
1 3 6 5 3 1 2 6 5 8 2 10 1 3 7 7 10 2 9 
6 7 3 4 7 7 2 4 2 9 9 1 3 5 8 10 5 7 4 
7 8 10 6 2 5 3 8 4 8 2 1 4 10 9 8 5 7 7 
4 1 10 8 9 1 4 9 10 9 2 9 4 10 7 2 6 8 8 
9 3 1 1 5 8 3 8 1 10 1 7 8 8 10 6 1 5 7 
4 4 4 4 4 4 7 2 2 9 1 8 6 8 4 8 1 7 4 
10 5 7 10 5 1 7 10 4 10 2 7 2 7 1 8 7 1 10 
9 4 4 1 5 5 2 2 9 3 4 6 7 6 9 6 10 4 10 
10 2 8 1 5 7 4 5 4 10 8 4 4 2 7 3 8 8 5 
9 2 6 10 4 2 8 3 10 2 6 3 2 4 3 1 10 6 6 
2 7 8 5 6 10 10 8 7 1 3 3 1 1 2 10 1 3 6 
7 5 5 8 8 3 10 5 5 8 2 1 4 10 10 3 5 9 7 
