6 10 2 10 4 2 3 10 4 9 9 8 2 6 3 3 3 7 8 
3 7 1 4 8 6 1 5 3 10 9 4 7 8 4 10 1 4 6 
4 5 10 6 10 1 8 1 4 8 5 9 4 9 10 2 2 9 4 
4 3 5 5 7 9 1 3 9 5 7 1 4 7 10 1 1 9 3 
10 6 8 9 2 10 3 5 9 8 3 9 7 8 1 6 10 8 7 
1 1 9 3 2 8 10 7 6 7 9 7 5 8 8 10 5 5 4 
3 9 8 3 3 4 5 9 2 10 7 1 2 8 9 6 7 2 1 
3 4 1 1 1 5 5 7 4 3 2 10 2 2 5 5 2 9 3 
3 6 1 5 8 2 3 4 6 2 10 1 10 2 8 1 5 6 1 
1 10 7 7 3 10 2 8 3 8 2 4 9 3 9 1 9 4 8 
9 4 2 3 7 1 2 2 8 8 3 1 6 8 3 2 7 6 1 
10 5 7 2 2 8 1 6 2 10 7 7 8 8 1 7 4 8 2 
1 6 4 8 6 9 7 9 10 5 2 10 3 9 7 6 4 8 10 
6 10 1 5 7 1 5 3 3 7 1 7 5 5 3 5 5 10 1 
4 4 6 3 3 5 5 10 4 4 3 9 7 8 3 3 5 6 8 
4 7 8 5 3 3 2 3 10 6 5 7 8 4 6 7 2 10 1 
9 9 6 2 7 6 1 6 2 3 8 7 9 6 8 6 10 5 1 
8 5 5 9 3 2 4 10 1 9 10 7 4 5 4 8 10 4 4 
8 6 1 8 9 2 9 6 9 9 5 3 5 10 7 7 7 1 7 
