2 9 10 5 4 10 9 6 2 2 9 2 4 4 10 9 3 8 4 
10 3 10 6 9 7 8 9 9 5 10 3 8 5 3 1 8 7 3 
4 2 1 8 6 6 10 9 9 9 10 1 1 2 1 1 1 9 3 
3 9 5 10 6 1 5 4 2 3 8 3 3 9 1 4 4 1 5 
1 4 1 6 7 3 10 3 1 2 6 4 10 3 8 1 1 6 6 
2 10 2 2 10 1 4 3 6 1 8 2 5 8 5 6 2 5 7 
10 1 2 9 10 9 4 10 10 9 7 8 10 1 7 3 5 2 1 
9 10 7 5 4 8 10 3 2 9 4 5 5 1 8 8 1 10 3 
3 2 2 4 5 2 6 1 2 5 4 1 10 5 10 6 1 10 9 
9 9 9 2 10 7 5 5 1 10 4 4 10 4 7 1 8 4 10 
7 9 10 10 7 10 8 10 10 2 5 4 1 1 3 10 8 5 2 
7 6 7 5 2 6 5 3 5 4 4 4 7 9 1 5 8 3 6 
4 4 5 8 2 6 7 6 7 6 3 4 1 3 3 1 9 6 2 
10 5 2 4 4 1 5 6 9 10 3 2 2 1 4 9 5 3 8 
2 2 2 9 1 10 8 4 10 1 7 7 1 8 3 9 6 5 8 
5 1 10 1 2 2 7 3 5 4 6 4 7 5 8 4 7 7 10 
3 2 9 10 8 5 9 1 8 2 1 10 10 4 10 2 1 9 6 
8 8 9 5 5 4 1 6 8 6 4 7 1 7 1 5 3 4 5 
8 10 6 4 2 7 5 10 9 2 9 1 3 1 7 3 6 4 7 
