6 4 1 7 6 2 5 7 9 4 7 7 7 9 1 10 7 10 3 
8 5 6 4 4 2 8 7 3 4 9 1 1 4 10 10 8 6 10 
5 5 9 10 7 4 7 5 10 10 9 5 8 10 9 10 1 7 7 
9 5 5 5 4 4 2 4 6 8 6 3 2 5 2 1 5 8 2 
9 8 10 1 9 4 1 3 2 7 9 2 4 9 2 9 7 9 3 
1 6 4 6 10 4 2 10 9 5 3 8 3 4 9 1 3 8 4 
3 4 3 9 10 3 3 5 4 5 10 2 10 5 1 6 2 8 7 
2 10 3 1 3 1 7 4 8 2 9 3 9 7 2 10 6 7 3 
1 4 1 8 9 9 10 9 3 4 2 7 6 8 9 5 7 8 8 
7 10 3 9 3 10 6 6 4 9 6 9 9 8 4 6 2 4 10 
6 2 8 7 6 3 6 10 3 1 5 2 3 1 7 10 10 6 3 
3 9 3 5 9 4 2 1 1 2 4 3 1 6 4 9 9 3 3 
3 6 9 8 1 3 5 5 9 2 6 8 6 1 1 7 9 5 2 
1 5 10 3 3 3 8 2 9 7 9 4 6 10 8 7 10 5 10 
4 3 8 1 4 1 3 2 5 5 2 2 5 1 2 6 1 5 10 
4 7 2 10 8 7 1 8 7 9 2 3 2 6 4 10 3 2 5 
6 8 1 3 6 9 8 1 4 1 9 7 10 1 3 9 5 8 2 
5 3 9 10 8 10 3 2 9 6 1 8 4 1 5 1 2 3 4 
9 7 8 6 5 1 9 7 8 7 3 9 3 1 6 8 3 4 5 
