6 1 9 5 10 1 6 2 7 1 9 2 7 9 2 3 6 4 10 
4 4 2 4 3 3 4 1 8 6 3 5 8 8 5 7 9 4 10 
10 10 4 9 7 8 6 1 3 3 6 4 5 2 6 7 8 10 6 
1 10 8 2 7 8 8 10 8 10 10 9 3 3 1 4 6 4 3 
9 10 6 9 7 2 6 10 10 3 1 7 10 10 7 1 5 4 9 
2 7 10 6 1 9 9 1 10 4 9 4 8 5 5 2 4 9 9 
3 9 8 1 2 3 7 4 4 1 10 5 7 7 2 4 1 7 3 
10 5 2 5 10 1 8 6 7 4 1 5 6 6 2 8 6 9 5 
9 4 2 8 8 7 7 7 4 4 3 3 8 8 7 9 3 10 4 
10 3 4 1 9 4 3 6 9 2 6 6 3 2 8 9 9 7 6 
3 1 9 3 1 4 6 7 5 2 6 10 2 8 1 5 1 2 1 
1 5 3 8 9 1 9 7 5 1 3 7 3 9 2 9 4 2 9 
6 7 1 10 6 8 10 1 2 2 2 5 6 2 10 1 8 4 3 
4 5 7 7 4 9 4 9 6 2 9 4 4 3 5 4 6 1 2 
5 10 2 1 8 9 10 4 7 2 10 2 6 4 9 2 9 10 10 
5 10 1 4 2 9 4 7 6 5 7 1 10 10 6 10 4 3 9 
1 7 4 3 2 5 10 2 7 10 5 6 7 6 6 2 9 5 5 
3 6 8 8 10 6 2 8 4 1 9 3 4 5 5 6 4 7 2 
8 10 9 2 10 4 1 5 3 1 1 2 9 7 3 8 5 4 2 
