10 6 3 6 7 8 9 3 7 3 7 1 10 3 8 9 1 6 4 
5 4 2 3 6 7 2 7 7 10 10 6 8 3 10 1 4 6 3 
3 5 5 6 10 2 9 10 7 2 4 6 10 1 8 10 10 3 1 
3 8 5 9 7 7 3 6 7 3 7 2 10 1 6 8 4 2 3 
1 3 7 2 2 10 4 1 4 6 10 8 2 4 7 7 10 5 4 
8 6 2 1 5 4 2 1 2 3 7 2 6 7 1 4 8 4 7 
8 1 7 7 3 4 9 6 8 4 3 9 5 7 6 3 7 6 5 
2 6 3 6 2 4 6 8 5 9 10 6 10 6 9 10 4 2 9 
5 8 7 10 9 5 3 2 4 9 10 6 1 4 4 2 8 8 10 
3 1 7 4 8 7 1 2 9 8 9 9 7 4 8 8 3 8 6 
8 3 9 4 8 4 9 10 4 3 3 10 6 1 9 6 8 4 8 
1 3 8 4 8 9 4 8 3 5 2 7 8 6 8 5 5 6 3 
7 3 6 10 7 7 3 1 6 9 2 8 5 2 3 3 7 2 10 
3 6 3 4 7 5 8 9 8 3 1 1 4 1 6 4 4 3 3 
5 1 1 9 6 3 1 7 6 2 6 8 8 8 8 3 1 4 5 
5 7 8 5 2 1 1 6 7 10 2 6 6 3 8 1 10 2 6 
10 1 8 5 6 5 3 9 5 8 7 2 6 5 6 3 8 1 2 
6 7 9 8 6 6 9 3 4 7 10 9 7 9 4 7 6 1 7 
6 5 1 7 10 3 1 9 10 7 1 1 9 2 4 4 7 4 7 
