12 6 3 3 12 4 3 8 3 5 12 9 9 6 10 3 6 12 7 
7 10 5 3 7 6 3 3 9 5 6 6 8 9 5 10 7 10 8 
4 11 10 4 7 5 8 10 10 8 3 5 9 8 11 5 3 7 6 
5 4 3 3 4 10 5 3 8 12 11 5 11 12 10 12 9 10 12 
8 9 3 6 6 12 6 3 3 6 9 4 10 12 7 7 7 7 8 
4 4 9 11 3 6 8 10 11 3 3 3 6 7 8 5 4 6 6 
6 5 8 10 6 4 3 4 6 7 10 5 6 11 9 8 3 8 11 
11 4 10 4 10 11 9 4 7 6 8 12 9 9 6 7 3 10 7 
6 12 9 7 8 12 12 3 7 9 11 4 4 11 12 10 11 4 6 
9 10 10 6 4 3 10 6 4 6 7 11 10 10 3 8 4 12 8 
8 12 8 8 8 11 3 7 6 12 3 6 7 8 10 12 5 10 4 
8 10 12 6 3 9 12 4 4 5 10 12 3 6 7 5 3 10 4 
4 5 4 10 9 9 5 4 3 12 3 8 6 7 5 10 5 7 7 
5 8 6 8 5 11 4 9 6 12 8 8 11 6 8 11 12 10 6 
4 11 10 7 8 12 10 11 8 4 6 4 5 9 9 5 9 8 11 
6 10 9 9 12 8 7 12 10 6 4 7 6 7 6 10 7 6 6 
4 11 7 12 10 9 10 12 6 11 12 3 9 4 9 9 3 10 12 
6 12 10 3 8 8 5 12 6 4 5 12 9 11 4 8 7 8 5 
10 3 10 11 12 9 12 4 11 12 11 4 10 6 5 5 11 8 10 
