2 2 10 2 1 8 4 10 1 9 7 1 5 7 9 2 4 5 2 
8 10 5 2 9 2 6 3 2 5 1 9 3 4 5 10 9 7 1 
3 10 9 4 9 2 10 2 8 7 8 3 7 8 3 10 9 8 3 
7 8 10 7 3 3 8 4 3 2 3 8 6 10 3 8 3 2 10 
1 10 2 4 3 8 10 6 5 2 2 8 4 3 5 5 8 5 6 
8 9 4 10 9 5 9 7 10 9 3 3 4 4 6 9 9 3 8 
7 2 5 10 7 1 2 8 6 6 8 8 3 1 7 7 10 6 10 
7 9 4 7 7 9 9 8 8 7 2 8 4 7 5 9 6 1 10 
7 8 2 10 2 8 4 2 6 2 2 7 8 2 1 3 2 1 5 
5 7 2 6 7 10 8 6 10 6 10 8 10 2 6 4 1 2 3 
2 6 2 9 8 10 3 6 4 7 1 5 8 9 8 9 3 6 7 
7 10 9 3 1 7 1 3 6 2 2 9 9 2 3 3 1 7 9 
3 4 9 9 2 9 9 1 1 7 3 3 3 5 2 3 6 3 6 
1 10 1 3 4 7 7 7 6 6 7 9 9 6 10 1 10 9 1 
3 8 4 4 6 3 7 2 1 9 5 4 4 7 1 1 3 2 6 
10 10 10 9 9 3 5 4 6 3 5 6 4 10 5 2 2 9 3 
7 9 3 5 3 2 8 6 10 6 2 4 1 2 2 1 7 9 5 
10 7 9 1 1 5 5 3 2 6 8 4 8 8 8 6 4 7 2 
1 7 9 5 2 2 10 3 4 1 8 9 3 5 10 3 8 10 4 
