6 8 2 6 10 5 5 7 4 3 3 2 10 7 2 5 2 5 7 
10 3 2 3 4 4 5 4 10 3 3 9 6 10 7 5 3 5 4 
4 10 10 3 3 6 10 8 6 4 10 9 10 4 4 5 5 6 4 
9 4 1 8 2 10 2 10 6 7 5 3 8 7 3 8 3 9 8 
2 3 7 6 9 9 5 1 1 10 10 2 10 9 10 3 8 8 3 
2 4 1 5 8 2 5 5 5 4 3 1 7 5 9 8 9 2 3 
10 9 10 10 10 4 6 9 5 8 3 1 7 6 10 8 10 6 4 
3 5 5 6 7 10 1 1 4 10 7 9 6 8 3 8 7 1 3 
1 9 9 5 6 10 2 2 8 4 6 3 10 5 10 9 7 2 10 
7 2 10 7 3 10 9 9 4 9 5 6 10 7 8 5 9 9 3 
5 2 6 10 8 2 2 10 7 3 3 4 3 6 1 5 3 8 10 
7 8 3 3 8 9 1 9 4 3 6 2 6 5 1 10 2 2 5 
6 10 9 1 9 9 9 10 8 4 5 9 7 9 4 10 4 5 7 
9 4 3 8 9 5 10 5 9 8 10 9 2 4 9 1 9 8 8 
1 10 1 3 3 2 2 6 2 7 8 7 3 8 10 10 6 8 4 
2 10 2 3 2 3 2 10 3 7 9 8 5 7 9 8 10 10 3 
1 5 9 3 3 2 4 1 3 8 8 1 5 6 8 9 5 7 7 
7 10 9 4 7 3 1 3 5 8 2 6 2 9 7 9 5 1 10 
3 9 6 3 9 5 10 8 7 5 7 4 10 4 4 7 4 1 8 
