3 7 1 6 9 3 9 6 6 10 6 3 1 6 9 5 1 10 6 
4 6 2 8 3 6 10 5 6 2 9 7 2 4 7 8 7 8 10 
8 2 7 9 2 1 8 3 5 10 1 10 6 9 4 2 10 10 4 
3 8 9 6 10 5 8 9 7 9 10 6 4 2 5 1 8 8 4 
3 5 6 6 10 2 9 2 6 10 10 7 4 9 10 9 6 3 2 
1 10 8 3 9 8 9 7 1 2 10 8 1 2 10 9 1 2 1 
5 1 10 1 4 3 7 4 4 6 10 9 8 6 5 10 2 5 7 
10 4 10 7 10 6 7 9 7 1 7 7 4 9 6 2 8 6 9 
9 4 9 2 1 5 3 3 7 2 4 2 9 5 4 10 4 9 8 
10 3 8 1 8 4 9 2 1 6 6 9 1 4 4 5 4 8 4 
7 10 7 10 8 5 1 6 5 3 9 6 2 1 7 10 9 2 2 
7 7 8 9 3 9 3 4 2 9 6 7 1 6 9 9 2 7 10 
4 4 2 1 5 4 5 2 3 1 3 1 1 4 9 1 4 4 9 
10 4 7 3 8 4 3 2 10 1 4 4 6 7 8 8 8 4 2 
8 1 1 6 10 9 1 3 8 6 9 7 8 5 1 4 2 6 5 
8 1 2 10 1 6 3 4 2 5 1 1 4 4 4 4 2 3 1 
1 6 4 5 10 2 2 6 7 6 1 6 1 1 10 5 7 5 5 
8 2 8 4 8 8 3 1 1 8 4 10 1 5 2 4 3 2 4 
10 8 4 10 2 4 8 2 8 3 5 3 5 9 9 9 7 4 7 
