3 1 2 10 8 6 5 1 2 4 7 7 2 5 4 1 9 6 4 
5 3 7 9 3 3 2 9 6 9 7 2 7 4 1 6 5 6 10 
10 5 4 5 3 10 3 3 6 1 7 3 4 10 10 10 10 1 9 
3 4 4 7 7 2 10 10 3 6 9 5 2 7 5 3 4 6 9 
5 8 7 2 10 4 2 5 9 4 4 10 6 8 10 8 4 5 1 
6 8 6 3 2 4 7 7 3 3 6 6 2 5 2 4 1 8 1 
4 2 6 6 1 8 1 7 1 2 9 5 1 7 7 7 5 1 4 
2 5 9 7 4 5 3 8 1 1 1 4 7 3 9 4 6 3 4 
8 6 1 5 7 5 4 4 5 10 3 7 4 9 3 10 4 8 7 
9 9 1 9 2 6 9 5 4 9 8 8 4 2 9 7 10 2 4 
2 3 4 10 5 10 9 3 5 10 9 2 4 3 3 6 5 8 9 
8 3 8 2 9 10 6 2 2 5 7 5 5 3 10 3 6 7 2 
9 9 10 10 8 2 5 5 1 8 10 6 10 2 2 5 4 2 7 
3 6 10 8 8 10 3 1 4 2 9 5 10 9 9 5 10 10 10 
4 3 8 5 9 4 1 9 2 9 6 4 7 9 7 6 4 5 1 
4 6 7 8 9 4 8 4 4 2 8 2 3 5 9 2 3 4 10 
6 4 2 6 7 5 4 4 9 1 8 2 6 2 8 8 7 6 10 
4 5 8 10 7 5 8 4 4 4 9 10 1 10 2 4 6 7 1 
7 3 1 1 10 8 5 9 10 7 9 9 6 2 1 2 5 5 8 
