1 4 7 7 6 5 7 8 5 7 8 8 3 7 6 10 4 6 9 
6 1 9 6 1 6 3 6 5 2 7 6 7 4 5 7 8 7 1 
7 1 8 3 9 2 7 1 4 3 2 8 1 4 8 9 10 10 5 
7 7 6 9 2 10 1 2 8 7 8 5 2 7 1 7 4 3 8 
9 8 6 4 5 10 10 5 5 7 2 6 9 5 4 3 4 7 5 
3 3 9 4 3 5 8 9 3 1 9 8 1 3 10 2 1 5 3 
2 3 10 6 6 2 5 1 4 2 10 3 4 3 2 5 3 8 6 
5 9 8 3 9 7 9 6 2 10 8 3 5 5 6 2 8 10 6 
10 3 6 7 2 4 9 6 7 5 10 4 10 10 10 3 10 4 4 
7 4 4 8 4 2 9 9 4 6 1 10 2 5 10 2 4 9 8 
8 4 1 9 8 5 3 6 6 3 6 4 8 9 10 7 6 9 9 
5 7 6 9 2 9 8 3 5 5 6 6 4 7 9 4 5 3 5 
4 1 10 9 2 1 10 5 4 2 10 9 3 4 9 7 6 8 3 
9 9 7 1 4 9 5 8 2 1 10 7 6 3 6 5 10 9 1 
4 2 3 9 8 1 4 3 1 3 2 7 8 4 4 3 4 10 9 
8 7 1 1 5 10 1 3 8 7 3 2 4 10 2 6 5 2 3 
7 4 9 10 8 2 6 9 5 1 4 2 2 9 9 6 9 5 2 
7 9 10 6 6 3 6 4 9 2 6 6 8 7 4 3 8 10 2 
7 4 3 1 7 7 7 3 6 4 2 3 7 4 8 2 8 5 2 
