8 7 4 7 2 8 1 3 5 4 6 2 7 7 9 2 4 5 8 
1 1 8 9 3 3 4 5 6 6 10 6 2 3 4 1 2 3 10 
5 9 8 2 3 3 1 2 4 5 9 5 6 3 6 6 3 6 3 
3 9 6 7 10 6 1 8 10 5 1 7 10 4 9 7 7 7 3 
8 3 7 5 10 10 2 10 3 6 5 8 9 8 10 10 4 5 2 
4 1 7 9 5 8 9 7 3 4 1 7 7 4 1 9 1 7 10 
6 7 2 6 9 8 4 1 6 8 4 8 6 9 2 1 4 5 6 
3 9 6 2 3 7 8 3 6 10 9 9 3 3 4 9 6 8 9 
2 2 9 9 2 9 10 6 9 6 1 8 7 10 7 9 7 7 1 
7 10 10 5 8 6 2 3 4 7 6 7 3 6 7 8 2 8 10 
2 6 3 1 7 4 8 8 5 3 10 6 7 8 7 9 4 10 1 
7 3 2 2 4 5 10 10 5 9 1 5 6 3 5 2 9 6 3 
3 2 8 8 5 1 3 3 3 6 2 10 2 1 10 4 3 3 5 
5 4 10 7 7 3 9 7 9 1 8 1 3 3 4 6 8 8 5 
2 3 5 10 6 3 2 4 5 5 2 2 7 7 6 4 1 2 8 
2 9 5 5 8 10 6 9 10 3 10 6 4 7 9 1 5 5 1 
9 8 1 5 6 5 8 9 9 2 6 3 2 1 6 10 8 10 8 
6 1 9 2 7 7 6 9 3 5 9 8 7 1 8 3 3 1 10 
6 7 9 7 3 7 5 6 10 6 8 8 3 7 5 2 8 6 4 
