1 8 6 3 3 2 8 1 6 2 5 4 1 8 3 10 6 5 5 
3 10 5 9 9 6 8 4 9 3 6 1 2 10 3 8 5 6 6 
3 3 10 1 10 8 7 4 9 3 8 1 7 8 6 2 9 3 1 
10 3 7 3 8 1 10 6 4 4 1 9 4 9 5 9 1 10 2 
7 10 3 10 2 7 8 9 6 2 5 4 7 10 4 7 5 5 2 
10 8 5 1 5 9 9 1 1 1 8 5 10 7 5 6 2 7 6 
2 6 3 4 1 8 6 4 8 4 10 1 10 2 2 9 3 1 4 
8 1 8 5 4 2 8 7 9 4 3 7 9 4 3 10 8 9 8 
2 5 6 8 8 5 7 5 8 9 10 5 2 8 4 3 4 6 4 
5 10 6 7 5 7 3 3 2 1 6 10 10 7 5 4 6 9 5 
3 4 3 8 3 3 2 3 1 6 10 3 3 1 5 6 7 6 7 
1 10 1 6 1 5 9 4 6 4 1 10 6 2 1 9 5 7 6 
2 2 2 9 3 7 4 2 8 10 5 2 9 7 6 4 7 10 5 
2 10 5 6 1 1 4 6 10 2 3 10 10 9 7 4 6 3 2 
10 6 7 6 8 7 2 2 7 2 8 1 9 5 5 5 2 6 4 
2 1 8 1 7 3 2 5 9 6 7 7 5 9 5 2 4 8 7 
4 9 5 3 8 4 3 9 9 3 4 8 2 3 5 8 8 8 5 
5 8 4 4 3 1 2 6 4 10 2 9 8 1 5 9 3 2 6 
1 10 4 8 7 5 3 9 2 4 3 3 7 9 7 5 5 6 3 
