3 7 10 3 9 7 7 7 5 3 6 8 10 11 10 4 12 3 6 
7 12 8 3 3 3 8 7 12 11 5 11 7 10 11 5 5 3 9 
4 5 6 12 11 10 9 7 11 7 3 8 12 4 6 3 9 4 4 
3 10 9 8 12 9 5 6 11 11 4 12 9 8 4 5 6 4 3 
5 5 12 10 3 11 12 10 3 11 12 8 9 7 8 11 8 9 11 
12 9 5 10 12 7 9 10 3 7 8 8 3 6 11 11 8 10 6 
5 11 7 10 3 3 10 3 6 11 8 12 8 6 5 11 3 12 6 
7 12 11 6 4 3 4 4 5 9 8 8 9 8 10 4 6 11 5 
9 9 11 9 8 3 5 8 12 12 11 11 11 12 9 10 3 6 10 
11 11 11 5 12 11 5 5 4 10 10 12 3 5 5 4 3 4 5 
4 9 6 8 3 3 4 12 6 10 10 12 4 11 3 9 8 6 8 
11 6 12 3 9 8 8 10 8 10 4 12 4 4 5 8 11 10 12 
11 11 6 8 3 11 4 3 4 3 5 10 11 4 5 6 7 6 8 
9 8 11 9 11 6 3 3 7 10 12 7 11 6 6 10 7 10 4 
7 11 6 11 3 9 7 7 11 12 10 5 4 7 3 5 4 8 9 
8 3 6 11 3 5 7 9 9 9 10 5 7 6 3 3 5 7 4 
10 3 9 9 6 10 11 6 10 10 6 7 6 11 11 4 9 6 6 
8 7 10 4 8 5 12 8 6 11 11 5 10 9 3 8 4 12 11 
9 10 9 6 10 3 3 11 10 11 9 4 7 12 4 12 12 7 12 
