6 4 2 10 10 7 7 4 10 7 6 2 1 3 7 8 6 4 5 
5 8 6 7 1 9 1 2 3 3 8 3 2 1 10 6 8 9 7 
8 7 9 3 10 8 3 3 2 10 8 2 8 2 7 5 8 2 4 
2 4 2 8 7 7 10 1 1 3 4 4 3 8 3 6 2 8 2 
8 1 5 4 9 4 2 10 9 5 2 10 7 4 2 1 4 6 10 
10 7 8 2 2 7 7 6 6 1 2 7 6 4 1 2 7 4 2 
5 1 6 10 1 4 1 9 9 6 10 1 10 4 1 7 4 5 10 
1 5 8 10 7 2 6 2 3 5 10 9 6 2 6 4 6 10 1 
4 6 7 4 2 8 4 7 9 5 9 10 8 7 4 10 6 1 10 
3 10 5 5 4 2 8 8 9 6 10 1 4 9 7 1 5 9 10 
1 6 3 10 6 1 5 1 1 7 5 4 1 6 1 3 10 7 9 
3 9 10 8 2 5 3 4 3 2 4 9 3 5 9 3 10 7 1 
9 9 5 9 4 1 10 1 10 7 7 5 6 2 7 2 8 4 1 
10 2 8 5 4 8 4 8 3 9 10 8 10 8 3 5 7 6 7 
5 7 3 3 5 5 9 9 7 8 8 7 8 3 1 2 7 5 10 
9 9 10 9 6 8 7 6 9 4 2 7 3 4 9 6 2 7 8 
6 8 9 6 6 1 5 6 9 8 6 2 9 4 10 9 7 6 2 
7 9 9 8 5 5 3 10 5 7 3 2 3 2 3 4 5 8 10 
2 3 2 8 3 4 5 6 2 3 8 9 6 4 5 9 3 2 8 
