6 10 1 1 3 5 10 4 6 7 1 3 3 3 9 1 4 6 7 
10 5 3 2 9 6 5 8 8 4 3 5 4 3 3 2 4 8 8 
10 5 1 1 10 6 1 8 1 6 7 9 2 6 4 1 4 7 9 
2 2 3 9 6 5 10 1 5 5 1 9 6 8 5 9 9 7 5 
5 8 5 1 3 8 6 8 2 5 2 1 2 1 8 2 1 5 7 
3 6 5 3 2 10 9 1 9 7 8 10 1 5 6 1 9 6 7 
6 7 2 10 5 10 4 8 3 2 2 6 4 8 8 10 1 7 7 
4 9 9 3 8 5 4 9 5 2 2 6 7 4 1 10 4 4 8 
1 4 8 2 8 8 9 10 5 1 2 1 6 4 6 6 8 7 5 
3 9 4 6 9 5 4 5 2 1 5 10 4 3 8 8 5 7 4 
7 9 4 1 7 10 8 8 7 9 6 6 3 5 6 10 7 5 4 
8 7 10 7 2 2 5 4 10 9 3 4 4 7 2 2 5 7 10 
7 6 10 5 5 5 8 8 6 3 10 6 3 6 3 4 7 9 9 
7 6 2 6 7 1 6 1 10 3 5 6 7 9 8 8 5 1 4 
7 3 3 7 2 2 6 10 2 10 5 8 8 3 1 3 4 4 10 
3 8 5 6 9 7 2 6 4 8 5 6 4 8 9 5 3 5 6 
10 10 5 8 3 6 3 2 3 5 2 10 1 7 9 3 5 1 3 
6 4 10 1 9 1 6 9 3 10 10 7 3 9 1 5 5 9 5 
5 2 5 8 9 9 2 8 9 7 4 2 1 10 3 4 2 9 6 
