6 8 2 4 7 4 4 8 6 6 3 10 6 6 10 9 7 1 4 
10 5 9 1 1 2 7 8 10 7 5 10 3 7 3 8 5 4 6 
5 3 9 5 3 3 6 4 4 3 5 5 8 9 3 5 8 7 2 
9 5 2 10 5 7 4 10 4 7 4 6 1 10 9 1 3 2 6 
4 9 10 2 10 8 6 8 4 6 1 2 6 4 4 10 3 1 3 
7 3 6 7 5 9 4 2 10 8 7 2 3 9 10 1 8 8 8 
5 3 9 2 2 9 2 9 6 4 4 7 4 1 2 5 3 8 9 
2 3 10 8 3 6 4 1 10 2 10 7 10 10 5 10 6 8 6 
2 3 4 6 6 8 9 8 8 3 8 6 2 7 4 10 2 10 1 
5 4 2 9 10 6 8 9 6 6 1 6 4 5 9 1 6 7 10 
7 6 5 5 1 1 5 10 1 6 4 5 6 10 8 5 9 9 4 
2 7 3 1 8 7 7 2 5 5 8 3 4 1 5 4 1 4 4 
3 5 9 8 4 7 10 9 3 6 3 6 7 4 9 7 7 10 4 
1 5 2 8 8 3 5 5 5 3 6 9 8 7 2 7 10 10 9 
9 8 1 3 7 9 5 9 9 2 5 7 3 8 4 4 1 7 6 
10 9 4 2 5 6 3 1 10 1 6 4 10 1 10 10 9 4 8 
8 3 2 4 7 8 6 10 2 3 5 7 2 4 6 4 8 3 9 
5 7 2 8 10 3 1 7 3 10 10 5 10 7 5 8 9 8 9 
2 7 3 2 2 1 9 5 7 1 5 3 6 9 8 9 3 8 8 
