1 6 7 5 6 3 6 10 1 5 3 3 8 4 7 3 9 4 5 
4 10 9 3 7 3 5 2 2 5 4 3 7 9 10 8 10 1 7 
7 6 3 8 10 1 2 4 6 5 1 5 5 2 2 6 9 4 4 
4 4 5 9 9 8 2 8 6 4 10 3 2 10 2 5 8 1 4 
10 8 6 6 1 6 2 4 1 3 3 5 8 2 3 8 10 4 9 
2 4 10 7 5 7 10 1 8 7 9 5 4 3 3 1 1 10 10 
2 3 8 3 7 3 5 9 10 9 9 4 9 2 9 1 8 2 5 
4 8 1 2 6 2 9 6 1 10 1 4 2 10 9 6 1 7 2 
6 10 5 5 4 3 8 1 8 10 7 9 4 3 7 9 7 7 3 
2 8 9 1 6 5 8 8 10 6 10 3 2 6 6 1 4 2 1 
9 4 5 3 9 2 5 2 4 8 4 5 10 8 8 2 1 10 10 
10 1 10 8 2 9 6 10 8 10 7 3 7 5 8 9 7 3 2 
9 4 7 9 5 3 9 8 9 8 4 3 2 3 3 6 1 9 1 
10 9 10 8 8 8 8 4 8 3 1 9 7 1 3 2 8 5 9 
8 3 6 4 10 7 9 4 6 6 1 6 7 6 4 6 5 1 9 
6 4 6 6 7 1 7 4 7 4 6 2 4 9 2 9 1 3 6 
4 10 6 6 8 8 4 7 4 3 5 3 7 6 1 8 7 4 8 
9 5 7 9 1 7 7 8 2 9 3 1 4 1 3 8 1 5 5 
4 1 2 8 1 4 5 5 7 1 3 9 1 7 7 6 4 3 9 
