4 6 6 10 1 1 8 2 7 2 9 7 5 3 4 6 6 4 5 
7 4 3 4 5 8 1 10 4 5 2 10 7 1 9 10 10 3 2 
1 10 2 2 4 6 1 4 3 1 3 10 7 3 5 1 3 1 5 
2 7 5 4 6 1 5 9 6 8 2 9 10 3 8 2 3 3 8 
5 6 1 7 3 1 8 4 4 7 10 6 3 4 2 9 9 4 5 
1 10 6 7 4 9 5 3 8 9 1 3 1 1 7 5 5 8 6 
1 2 2 3 9 9 6 9 1 8 2 4 1 6 3 2 2 7 4 
8 4 10 5 7 5 3 4 7 3 1 3 8 9 5 6 5 9 3 
5 10 4 8 7 1 9 8 5 7 2 5 2 1 1 8 3 5 2 
5 8 3 2 6 7 8 9 3 10 2 1 2 4 3 4 7 2 1 
6 10 4 1 1 5 9 6 6 9 5 9 7 10 9 5 7 8 10 
2 5 10 8 5 6 2 7 7 5 1 3 8 10 7 2 9 4 4 
9 2 4 3 7 10 7 4 8 1 9 6 10 8 3 10 3 2 5 
6 5 2 2 6 3 5 8 7 9 10 3 6 7 5 2 8 2 8 
3 5 3 4 7 3 2 3 3 3 4 5 2 3 2 6 6 5 7 
3 4 3 5 4 3 8 9 3 3 9 8 3 6 1 5 9 8 1 
9 9 9 1 1 1 8 3 4 10 4 9 3 4 5 10 7 9 4 
2 6 4 4 7 1 2 10 9 8 10 9 4 5 10 2 6 9 2 
8 3 5 6 5 7 10 6 2 10 9 2 7 5 9 5 6 10 3 
