7 10 9 6 9 6 5 5 3 8 8 3 4 10 6 7 2 2 10 
5 6 6 8 8 3 9 6 8 2 2 7 5 7 6 3 1 1 5 
5 1 9 9 5 3 2 6 5 6 3 1 6 9 9 8 3 3 8 
1 4 4 5 2 5 10 4 1 5 6 3 2 8 3 6 4 4 5 
10 4 5 3 2 9 4 10 8 7 4 8 7 1 2 2 1 7 5 
10 9 3 5 8 7 9 3 6 5 6 9 10 9 2 10 2 5 10 
6 9 4 5 6 2 1 2 9 10 2 9 7 1 8 10 7 2 10 
4 8 1 4 5 1 7 2 8 9 10 4 4 7 10 5 8 9 9 
3 8 1 2 5 2 10 7 5 2 10 9 9 2 5 8 9 6 9 
9 5 7 9 10 3 5 9 6 7 6 7 9 9 9 6 3 4 4 
3 6 3 6 4 2 4 1 1 4 4 2 7 9 4 6 7 3 2 
9 4 9 10 6 2 10 1 1 3 3 10 4 10 3 5 7 7 3 
4 10 10 1 7 1 7 8 4 3 10 3 6 5 7 10 3 8 3 
10 9 4 2 5 6 8 7 9 6 9 8 8 1 3 10 1 10 3 
7 9 7 1 9 2 6 7 4 8 10 5 1 8 1 8 8 10 7 
4 9 2 2 3 7 2 8 1 5 1 1 5 4 9 9 8 1 4 
1 1 9 10 7 4 4 1 1 1 5 7 9 6 6 1 10 1 1 
1 6 10 2 2 8 8 10 4 10 4 7 7 9 3 5 5 3 5 
8 3 6 2 9 5 6 8 8 6 8 9 6 2 1 6 8 9 1 
