9 8 2 1 4 8 7 1 4 8 9 4 4 5 4 4 4 3 6 
1 5 3 3 9 2 4 9 8 6 2 10 6 7 10 9 4 3 9 
8 8 3 3 10 6 4 4 9 1 1 5 10 2 6 10 2 5 1 
7 9 2 3 3 9 9 1 5 2 2 6 6 3 4 8 2 2 2 
1 8 7 7 4 10 1 1 6 2 3 9 7 3 5 8 7 3 1 
4 2 5 9 9 4 5 4 5 5 2 5 1 2 2 6 5 2 10 
9 4 6 6 4 8 6 6 9 10 5 7 7 7 7 5 10 4 2 
5 9 5 1 8 1 7 5 2 3 5 5 3 6 4 6 4 5 5 
7 7 6 3 10 2 1 4 1 10 9 1 1 3 2 2 5 7 4 
10 1 2 4 1 8 2 4 6 1 9 10 10 10 1 9 8 3 6 
7 7 4 3 1 4 6 3 9 9 5 3 4 4 10 10 7 4 8 
3 10 7 2 5 8 7 5 9 6 8 7 1 9 5 7 10 8 2 
3 10 8 5 9 5 4 2 1 9 8 8 6 6 8 8 10 7 5 
3 7 1 6 9 1 4 9 4 6 2 2 1 5 2 4 4 8 10 
4 8 2 2 1 3 9 10 7 1 4 2 6 2 7 8 7 4 10 
2 9 6 5 2 8 4 2 2 7 6 4 2 6 2 10 3 6 4 
7 10 10 6 7 9 2 6 1 5 1 5 7 6 5 6 3 4 1 
5 7 1 7 6 8 6 8 1 2 6 1 5 5 6 3 3 2 2 
9 8 1 6 10 4 4 6 8 3 7 10 6 6 10 7 8 2 1 
