10 6 3 1 9 2 8 8 7 5 1 2 5 3 3 1 1 7 7 
8 5 9 3 4 8 7 1 7 7 1 4 8 6 4 5 1 2 7 
1 7 4 3 9 2 3 6 1 9 2 9 9 5 8 4 8 10 5 
4 6 7 4 8 3 5 4 9 4 5 2 6 6 2 7 7 9 3 
7 1 4 5 5 8 5 3 9 10 9 6 7 2 10 10 1 10 9 
7 10 3 9 6 1 7 6 1 1 2 5 6 7 8 3 1 5 3 
10 3 8 2 4 5 1 9 1 10 1 6 3 10 3 5 2 6 1 
10 1 2 2 3 4 7 2 6 2 8 9 1 10 9 8 10 3 8 
6 4 5 5 7 1 7 4 3 4 6 9 1 1 2 8 1 2 5 
6 9 2 8 1 8 4 6 7 6 3 9 6 1 4 3 9 7 3 
6 6 5 2 3 9 7 8 6 9 8 8 10 8 7 10 7 2 7 
6 4 10 6 1 2 10 3 7 7 7 8 2 10 6 10 8 9 9 
6 10 9 1 6 10 1 7 7 1 6 7 7 5 8 8 9 7 8 
6 4 8 1 7 2 3 4 8 1 9 10 3 3 2 5 3 5 2 
2 7 10 5 9 6 8 7 1 7 9 6 9 2 9 6 5 7 5 
3 2 7 7 3 6 5 1 1 8 8 5 1 5 3 7 1 5 6 
1 10 4 4 9 6 9 6 4 1 8 2 10 8 5 7 10 1 7 
8 7 4 4 2 8 2 1 7 1 4 10 10 5 7 5 4 5 8 
1 9 8 3 8 9 5 3 5 4 5 2 6 1 8 1 8 7 9 
