8 2 8 1 8 8 5 10 4 9 3 2 6 1 4 5 8 8 8 
8 3 7 2 3 2 9 7 2 1 6 4 9 2 2 10 6 6 7 
4 7 2 10 3 4 9 5 1 2 8 4 4 9 7 10 2 8 9 
9 8 6 8 4 5 4 6 8 10 9 4 7 2 9 4 3 10 5 
8 2 1 3 4 7 9 3 6 6 10 5 2 4 3 7 8 7 5 
5 2 9 6 3 5 8 2 6 4 9 6 6 1 8 6 1 7 8 
8 8 1 10 2 5 3 1 5 1 3 6 5 4 8 6 10 5 7 
10 5 6 7 5 3 1 3 4 4 10 3 3 8 6 6 5 10 10 
1 2 7 10 8 3 4 1 6 2 3 5 8 8 7 10 8 2 7 
4 9 6 4 5 7 4 9 5 7 4 10 3 9 4 5 2 6 7 
5 8 3 1 5 5 8 8 7 4 9 9 8 1 1 4 9 2 4 
10 8 1 3 8 9 6 7 3 1 7 3 8 5 5 10 2 5 10 
6 9 7 8 10 1 6 10 1 10 10 10 1 6 4 6 2 10 10 
7 9 10 8 1 1 1 8 2 9 3 4 1 1 10 10 10 5 6 
5 8 8 3 10 9 10 8 3 7 7 8 10 2 6 6 3 1 9 
8 2 3 2 8 10 8 7 6 7 10 5 7 4 9 5 1 5 8 
2 4 2 8 10 1 3 3 2 6 2 9 1 2 6 3 10 10 10 
8 10 6 2 10 4 10 4 3 1 3 1 1 3 5 7 4 9 3 
1 8 9 7 8 5 3 8 1 6 3 10 3 3 6 2 4 8 4 
