4 10 10 4 10 10 3 6 8 5 1 10 9 9 7 3 10 3 6 
7 10 5 10 2 10 3 9 5 10 2 2 10 5 6 1 7 10 10 
9 6 10 2 1 7 3 9 5 2 4 1 10 8 5 1 3 6 3 
8 4 10 8 2 1 6 5 9 8 3 9 1 1 6 1 2 1 4 
2 8 5 9 9 2 5 1 9 9 7 9 9 4 2 6 6 6 6 
2 9 7 6 5 5 5 8 5 3 9 2 9 4 10 7 4 9 6 
8 8 5 5 3 3 2 4 10 9 2 3 3 4 3 10 5 4 6 
5 9 1 9 6 10 1 4 10 6 9 5 9 5 1 7 2 5 1 
10 6 5 3 7 9 4 9 2 3 6 8 5 4 4 6 8 2 2 
3 8 6 6 4 7 2 2 1 6 10 10 1 9 4 2 9 1 6 
2 6 6 2 10 1 4 7 6 8 1 1 5 1 9 8 4 10 8 
5 3 3 2 10 9 10 1 3 10 8 4 7 8 9 6 9 3 1 
5 4 5 4 9 7 2 2 8 9 6 8 8 7 1 6 5 4 9 
1 7 1 1 5 10 8 6 3 10 9 6 4 2 1 4 6 10 10 
8 7 5 2 9 3 6 8 8 9 5 4 1 8 9 4 6 2 7 
3 1 5 6 9 3 2 5 2 3 4 9 2 6 10 8 5 10 7 
4 8 6 2 4 1 6 2 10 7 2 9 9 3 5 6 6 4 1 
4 3 3 9 8 2 4 5 8 2 4 6 8 7 8 5 9 1 7 
5 10 10 7 8 1 7 7 5 8 8 10 4 3 3 8 9 5 1 
