2 10 8 9 3 7 10 7 4 1 1 3 7 2 8 9 4 6 2 
6 10 5 10 7 7 2 7 1 4 5 5 3 6 1 1 2 1 1 
1 4 1 4 1 5 1 6 4 1 7 9 6 8 5 7 2 7 8 
1 4 5 2 3 10 10 5 2 6 1 4 7 3 5 7 6 5 1 
8 9 9 7 10 1 6 6 5 8 1 10 10 2 9 10 9 1 2 
10 10 8 10 4 4 5 5 10 2 6 6 8 7 9 7 3 9 9 
10 1 4 8 6 3 7 3 3 7 1 2 2 5 3 2 10 2 10 
9 5 3 2 4 5 1 6 9 6 3 5 3 8 5 8 1 10 9 
1 3 5 8 10 9 5 2 6 10 1 6 6 1 2 8 3 3 2 
10 7 6 9 8 10 1 1 1 7 3 9 10 8 8 10 3 6 8 
10 6 7 1 2 6 2 5 10 3 5 3 1 2 4 8 2 5 9 
6 7 8 9 7 7 7 3 2 4 9 7 9 3 9 8 9 2 7 
6 3 6 9 5 2 6 10 1 1 6 3 4 2 3 6 6 4 6 
7 6 2 6 1 3 7 7 1 3 10 10 4 4 5 4 1 5 7 
5 4 2 8 4 4 5 7 4 8 10 10 6 2 3 6 5 10 6 
10 6 3 8 7 8 9 7 1 9 4 8 8 9 3 9 3 5 4 
7 4 10 10 5 3 10 8 7 8 4 10 8 10 3 8 5 2 3 
3 10 9 2 8 10 4 1 6 7 8 10 10 2 1 9 3 7 7 
8 6 10 10 2 5 6 3 2 3 8 3 7 3 1 9 6 6 2 
